membenci	ᨅᨌᨗ
benci	ᨅᨌᨗ
sepeda motor	ᨆᨚᨈᨚᨑᨚᨔᨛᨙᨄᨉ
air	ᨓᨙᨕ
kalajengking	ᨄᨈᨗᨀᨒ
wijen	ᨒᨛᨂ
pohon	ᨄᨚᨂ
Senin	ᨕᨙᨔᨙᨊᨙ
sepeda	ᨔᨛᨙᨄᨉ
senin	ᨕᨙᨔᨙᨊᨙ
rabu	ᨕᨑᨅ
selasa	ᨔᨒᨔ
minggu	ᨕᨛᨔᨚ ᨕᨖᨕᨗ
Bahasa Bugis	ᨅᨔ ᨕᨘᨁᨗ
mengganjar	ᨙᨌᨙᨌ
pohon	ᨄᨚᨂ
Korea	ᨀᨚᨑᨗᨕ
anjing	ᨕᨔᨘ
biologi	ᨅᨗᨕᨚᨒᨚᨁᨗ
bodoh	ᨅᨛᨂᨚ
bebal	ᨅᨛᨂᨚ
sontoloyo	ᨅᨛᨂᨚ
tolol	ᨅᨛᨂᨚ
dungu	ᨅᨛᨂᨚ
geblek	ᨅᨛᨂᨚ
goblok	ᨅᨛᨂᨚ
jumat	ᨍᨘᨆ
kamis	ᨀᨆᨗᨔᨗ
sabtu	ᨔᨈᨘ
bibir	ᨓᨗᨙᨓ
kemiri	ᨄᨛᨒᨛ
Jepang	ᨍᨛᨄ
mengkudu	ᨅᨍ
lidah	ᨒᨗᨒ
sepeda motor	ᨆᨚᨈᨚᨑᨚᨔᨛᨙᨄᨉ
bahasa bugis	ᨅᨔ ᨕᨘᨁᨗ
kuda	ᨕᨎᨑ
muara	ᨅᨅ
